Name	Recognition Site
AaaI	CGGCCG
AagI	ATCGAT
AanI	TTATAA
AarI	CACCTGC
AatI	AGGCCT
AatII	GACGTC
AauI	TGTACA
AbaI	TGATCA
AbeI	CCTCAGC
AbrI	CTCGAG
AbsI	CCTCGAGG
Acc113I	AGTACT
Acc16I	TGCGCA
Acc36I	ACCTGC
Acc65I	GGTACC
AccBSI	CCGCTC
AccEBI	GGATCC
AccII	CGCG
AccIII	TCCGGA
AceII	GCTAGC
AceIII	CAGCTC
AciI	CCGC
AclI	AACGTT
AclNI	ACTAGT
AclWI	GGATC
AcpI	TTCGAA
AcuI	CTGAAG
AcvI	CACGTG
Afa16RI	CGATCG
Afa22MI	CGATCG
AfaI	GTAC
AfeI	AGCGCT
AflII	CTTAAG
AgeI	ACCGGT
AhaB8I	GGTACC
AhaIII	TTTAAA
AhlI	ACTAGT
AhyI	CCCGGG
AitI	AGCGCT
AjiI	CACGTC
AjoI	CTGCAG
AliAJI	CTGCAG
AliI	GGATCC
AluBI	AGCT
AluI	AGCT
Alw26I	GTCTC
Alw44I	GTGCAC
AlwI	GGATC
AlwXI	GCAGC
Aor13HI	TCCGGA
Aor51HI	AGCGCT
AosI	TGCGCA
ApaCI	GGATCC
ApaI	GGGCCC
ApaLI	GTGCAC
ApiI	CTGCAG
AscI	GGCGCGCC
AseI	ATTAAT
AsiAI	ACCGGT
AsiGI	ACCGGT
AsiI	GGATCC
AsiSI	GCGATCGC
AsnI	ATTAAT
Asp10HI	TTCGAA
Asp26HI	GAATGC
Asp27HI	GAATGC
Asp35HI	GAATGC
Asp36HI	GAATGC
Asp40HI	GAATGC
Asp50HI	GAATGC
Asp713I	CTGCAG
Asp718I	GGTACC
AspA2I	CCTAGG
AspLEI	GCGC
AspMDI	GATC
AspMI	AGGCCT
AssI	AGTACT
AsuHPI	GGTGA
AsuII	TTCGAA
AsuNHI	GCTAGC
AviII	TGCGCA
AvrBII	CCTAGG
AvrII	CCTAGG
BalI	TGGCCA
BamHI	GGATCC
BanAI	GGCC
BanIII	ATCGAT
BauI	CACGAG
BavAI	CAGCTG
BavBI	CAGCTG
BavCI	ATCGAT
BavI	CAGCTG
BbeI	GGCGCC
Bbi24I	ACGCGT
Bbr7I	GAAGAC
BbrI	AAGCTT
BbrPI	CACGTG
BbsI	GAAGAC
BbuI	GCATGC
Bbv16II	GAAGAC
BbvAII	ATCGAT
BbvAIII	TCCGGA
BbvCI	CCTCAGC
BbvI	GCAGC
BbvII	GAAGAC
BccI	CCATC
Bce243I	GATC
Bce751I	GGATCC
Bce83I	CTTGAG
BceAI	ACGGC
BceBI	CGCG
BcefI	ACGGC
Bci29I	ATCGAT
BciBI	ATCGAT
BciVI	GTATCC
BclI	TGATCA
BcmI	ATCGAT
Bco116I	CTCTTC
Bco27I	CCGG
Bco5I	CTCTTC
BcoAI	CACGTG
BcoDI	GTCTC
BcoKI	CTCTTC
BcuI	ACTAGT
BdiI	ATCGAT
BecAII	GGCC
BepI	CGCG
BfaI	CTAG
Bfi57I	GATC
BfiI	ACTGGG
BfrBI	ATGCAT
BfrI	CTTAAG
BfuAI	ACCTGC
BfuCI	GATC
BfuI	GTATCC
BglII	AGATCT
Bim19I	TTCGAA
Bim19II	GGCC
BimI	TTCGAA
BinI	GGATC
BlfI	TCCGGA
Bli41I	ATCGAT
Bli736I	GGTCTC
Bli86I	ATCGAT
BliAI	ATCGAT
BliRI	ATCGAT
BlnI	CCTAGG
BloHII	CTGCAG
BluI	CTCGAG
BmcAI	AGTACT
Bme12I	GATC
Bme361I	GGCC
Bme585I	CCCGC
BmgBI	CACGTC
BmrI	ACTGGG
BmtI	GCTAGC
BnaI	GGATCC
BpiI	GAAGAC
BpmI	CTGGAG
BpoAI	ATTAAT
Bpu14I	TTCGAA
Bpu95I	CGCG
BpuAI	GAAGAC
BpuAmI	GAGCTC
BpuB5I	CGTACG
BpuEI	CTTGAG
BpuSI	GGGAC
BpvUI	CGATCG
Bsa29I	ATCGAT
BsaI	GGTCTC
BsaMI	GAATGC
Bsc91I	GAAGAC
BscAI	GCATC
BscCI	GAATGC
BscFI	GATC
BscI	ATCGAT
Bse1I	ACTGG
Bse3DI	GCAATG
BseAI	TCCGGA
BseCI	ATCGAT
BseGI	GGATG
BseKI	GCAGC
BseMI	GCAATG
BseMII	CTCAG
BseNI	ACTGG
BsePI	GCGCGC
BseQI	GGCC
BseRI	GAGGAG
BseX3I	CGGCCG
BseXI	GCAGC
BseYI	CCCAGC
BseZI	CTCTTC
BsgI	GTGCAG
Bsh1236I	CGCG
BshFI	GGCC
BshI	GGCC
BshTI	ACCGGT
BshVI	ATCGAT
BsiCI	TTCGAA
BsiI	CACGAG
BsiMI	TCCGGA
BsiQI	TGATCA
BsiSI	CCGG
BsiWI	CGTACG
BsiXI	ATCGAT
BslFI	GGGAC
BsmAI	GTCTC
BsmBI	CGTCTC
BsmFI	GGGAC
BsmI	GAATGC
BsnI	GGCC
Bso31I	GGTCTC
BsoMAI	GTCTC
Bsp105I	GATC
Bsp106I	ATCGAT
Bsp119I	TTCGAA
Bsp120I	GGGCCC
Bsp123I	CGCG
Bsp13I	TCCGGA
Bsp1407I	TGTACA
Bsp143I	GATC
Bsp153AI	CAGCTG
Bsp19I	CCATGG
Bsp2095I	GATC
Bsp211I	GGCC
Bsp4009I	GGATCC
Bsp423I	GCAGC
Bsp50I	CGCG
Bsp63I	CTGCAG
Bsp67I	GATC
Bsp68I	TCGCGA
Bsp98I	GGATCC
BspA2I	CCTAGG
BspAAI	CTCGAG
BspAAII	TCTAGA
BspAAIII	GGATCC
BspACI	CCGC
BspAI	GATC
BspANI	GGCC
BspBI	CTGCAG
BspBRI	GGCC
BspBS31I	GAAGAC
BspCI	CGATCG
BspCNI	CTCAG
BspDI	ATCGAT
BspEI	TCCGGA
BspFI	GATC
BspFNI	CGCG
BspHI	TCATGA
BspIS4I	GAAGAC
BspJI	GATC
BspJII	ATCGAT
BspKI	GGCC
BspKT5I	CTGAAG
BspKT6I	GATC
BspKT8I	AAGCTT
BspLAI	GCGC
BspLAII	TTCGAA
BspLAIII	AAGCTT
BspLU11I	ACATGT
BspLU11III	GGGAC
BspM39I	CAGCTG
BspM90I	GTATAC
BspMAI	CTGCAG
BspMI	ACCTGC
BspMII	TCCGGA
BspMKI	GTCGAC
BspO4I	CAGCTG
BspOI	GCTAGC 
BspOVII	ATCGAT
BspPI	GGATC
BspRI	GGCC
BspST5I	GCATC
BspT104I	TTCGAA
BspTI	CTTAAG
BspTNI	GGTCTC
BspTS514I	GAAGAC
BspXI	ATCGAT
BspXII	TGATCA
BspZEI	ATCGAT
BsrBI	CCGCTC
BsrDI	GCAATG
BsrGI	TGTACA
BsrI	ACTGG
BsrSI	ACTGG
BssHI	CTCGAG
BssHII	GCGCGC
BssIMI	GGGTC
BssMI	GATC
BssNAI	GTATAC
BssSI	CACGAG
Bst1107I	GTATAC
Bst11I	ACTGG
Bst12I	GCAGC
Bst19I	GCATC
Bst19II	GATC
Bst28I	ATCGAT
Bst2BI	CACGAG
Bst31NI	CCGCTC
Bst31TI	GGATC
Bst40I	CCGG
Bst6I	CTCTTC
Bst71I	GCAGC
Bst98I	CTTAAG
BstAFI	CTTAAG
BstAUI	TGTACA
BstBI	TTCGAA
BstBS32I	GAAGAC
BstBSI	GTATAC
BstBZ153I	GCGCGC
BstD102I	CCGCTC
BstENII	GATC
BstEZ359I	GTTAAC
BstF5I	GGATG
BstFI	AAGCTT
BstFNI	CGCG
BstFZ438I	CCCGC
BstGZ53I	CGTCTC
BstH9I	GGATC
BstHHI	GCGC
BstHPI	GTTAAC
BstI	GGATCC
BstKTI	GATC
BstMBI	GATC
BstNZ169I	ATCGAT
BstOZ616I	GGGAC
BstPZ418I	GGATG
BstPZ740I	CTTAAG
BstRZ246I	ATTTAAAT
BstSNI	TACGTA
BstSWI	ATTTAAAT
BstT7I	TGATCA
BstTS5I	GAAGAC
BstUI	CGCG
BstV1I	GCAGC
BstV2I	GAAGAC
BstVI	CTCGAG
BstZ17I	GTATAC
BstZI	CGGCCG
Bsu1532I	CGCG
Bsu15I	ATCGAT
Bsu23I	TCCGGA
Bsu6I	CTCTTC
BsuBI	CTGCAG
BsuFI	CCGG
BsuRI	GGCC
BsuTUI	ATCGAT
BteI	GGCC
BtgZI	GCGATG
BtkI	CGCG
BtkII	GATC
BtrI	CACGTC
BtsI	GCAGTG
BtsIMutI	CAGTG
BtuMI	tcgcga
BveI	ACCTGC
BvuBI	CGTACG
CacI	GATC
CauB3I	TCCGGA
CbiI	TTCGAA
CboI	CCGG
CciI	tcatga
CciNI	GCGGCCGC
CcoI	GCCGGC
CcrI	CTCGAG
CcyI	GATC
CdiI	CATCG
CelI	GGATCC
CeqI	GATATC
CflI	CTGCAG
CfoI	GCGC
Cfr42I	CCGCGG
Cfr6I	CAGCTG
Cfr9I	CCCGGG
CfrA4I	CTGCAG
CfrJ4I	CCCGGG
CfuI	GATC
CfuII	CTGCAG
ChaI	GATC
ClaI	ATCGAT
CltI	GGCC
CpfI	GATC
CscI	CCGCGG
CseI	gacgc
CsiAI	ACCGGT
CsiBI	GCGGCCGC
Csp45I	TTCGAA
Csp68KII	TTCGAA
Csp68KIII	ATGCAT
Csp68KVI	CGCG
Csp6I	GTAC
CspAI	ACCGGT
CspBI	GCGGCCGC
CspKVI	CGCG
CstI	CTGCAG
CstMI	AAGGAG
CviAI	GATC
CviAII	CATG
CviQI	GTAC
CviRI	TGCA
CviRII	GTAC
DinI	GGCGCC
DmaI	CAGCTG
DpaI	AGTACT
DpnI	GATC
DpnII	GATC
DraI	TTTAAA
DsaII	GGCC
EacI	GGATC
Eae46I	CCGCGG
EaeAI	CCCGGG
EagBI	CGATCG
EagI	CGGCCG
Eam1104I	CTCTTC
EarI	CTCTTC
EciI	GGCGGA
Ecl136II	GAGCTC
Ecl2zI	CTGCAG
Ecl37kI	CTGCAG
EclI	CAGCTG
EclRI	CCCGGG
EclXI	CGGCCG
Eco105I	TACGTA
Eco147I	AGGCCT
Eco255I	AGTACT
Eco29kI	CCGCGG
Eco31I	GGTCTC
Eco32I	GATATC
Eco47III	AGCGCT
Eco52I	CGGCCG
Eco53kI	GAGCTC
Eco56I	GCCGGC
Eco57I	CTGAAG
Eco72I	CACGTG
Eco78I	GGCGCC
EcoA4I	GGTCTC
EcoICRI	GAGCTC
EcoO44I	GGTCTC
EcoP15I	CAGCAG
EcoRI	GAATTC
EcoRV	GATATC
EcoT22I	ATGCAT
EcoVIII	AAGCTT
EgeI	GGCGCC
EheI	GGCGCC
ErhB9I	CGATCG
EsaBC3I	TCGA
EsaBC4I	GGCC
Esp3I	CGTCTC
Esp4I	CTTAAG
FaeI	CATG
FalII	CGCG
FaqI	GGGAC
FatI	CATG
FauBII	CGCG
FauI	CCCGC
FauNDI	CATATG
FbaI	TGATCA
FdiII	TGCGCA
FgoI	CTAG
FnuCI	GATC
FnuDI	GGCC
FnuDII	CGCG
FnuDIII	GCGC
FnuEI	GATC
FokI	GGATG
FseI	GGCCGGCC
FspBI	CTAG
FspI	TGCGCA
FspII	TTCGAA
FunI	AGCGCT
FunII	GAATTC
GalI	CCGCGG
GceGLI	CCGCGG
GceI	CCGCGG
GdiI	AGGCCT
GlaI	GCGC
GsaI	CCCAGC
GstI	GGATCC
GsuI	CTGGAG
HacI	GATC
HaeIII	GGCC
HalI	GAATTC
HalII	CTGCAG
HapII	CCGG
HgaI	GACGC
HgiCIII	GTCGAC
HgiDII	GTCGAC
HhaI	GCGC
Hin1II	CATG
Hin2I	CCGG
Hin6I	GCGC
HindIII	AAGCTT
HinP1I	GCGC
HjaI	GATATC
HpaI	GTTAAC
HpaII	CCGG
HphI	GGTGA
HpyAV	CCTTC
HpyBI	GTAC
HpyC1I	CCATC
HpyCH4I	CATG
HpyCH4IV	ACGT
HpyCH4V	TGCA
HpyCI	GATATC
HpyF44III	TGCA
HsoI	GCGC
Hsp92II	CATG
HspAI	GCGC
HsuI	AAGCTT
I-CeuI	TAACTATAACGGTCCTAAGGTAGCGA
I-PpoI	TAACTATGACTCTCTTAAGGTAGCCAAAT
I-SceI	TAGGGATAACAGGGTAAT
KasI	GGCGCC
Kpn2I	TCCGGA
Kpn378I	CCGCGG
Kpn49kI	GAATTC
KpnI	GGTACC
Ksp22I	TGATCA
Ksp632I	CTCTTC
KspAI	GTTAAC
KspI	CCGCGG
Kzo9I	GATC
LcaI	ATCGAT
LlaAI	GATC
LlaCI	AAGCTT
LlaG2I	GCTAGC
LplI	ATCGAT
LspI	TTCGAA
LweI	GCATC
MaeI	CTAG
MaeII	ACGT
MaeK81I	CGTACG
MalI	GATC
MauBI	CGCGCGCG
MavI	CTCGAG
MbiI	CCGCTC
MboI	GATC
MboII	GAAGA
MchAI	GCGGCCGC
MchAII	GGCC
MchI	GGCGCC
MfeI	CAATTG
MfoAI	GGCC
MgoI	GATC
MhaAI	CTGCAG
MkrAI	GATC
MlaAI	CTCGAG
MlaI	TTCGAA
MlsI	TGGCCA
MltI	AGCT
Mlu23I	GGATCC
Mlu31I	TGGCCA
MluB2I	TCGCGA
MluCI	AATT
MluI	ACGCGT
MluNI	TGGCCA
Mly113I	GGCGCC
MlyI	GAGTC
MnlI	CCTC
MnoI	CCGG
Mph1103I	ATGCAT
MreI	CGCCGGCG
MroI	TCCGGA
MroNI	GCCGGC
MscI	TGGCCA
MseI	TTAA
Msp20I	TGGCCA
MspCI	CTTAAG
MspI	CCGG
MspSWI	ATTTAAAT
MssI	GTTTAAAC
MstI	TGCGCA
MthZI	CTAG
MunI	CAATTG
Mva1269I	GAATGC
MvnI	CGCG
MvrI	CGATCG
MxaI	GAGCTC
NaeI	GCCGGC
NarI	GGCGCC
NblI	CGATCG
NcoI	CCATGG
NcrI	AGATCT
NcuI	GAAGA
NdaI	GGCGCC
NdeI	CATATG
NdeII	GATC
NgoAIII	CCGCGG
NgoAIV	GCCGGC
NgoMIV	GCCGGC
NgoPII	GGCC
NgoPIII	CCGCGG
NheI	GCTAGC
NlaII	GATC
NlaIII	CATG
NmeAIII	GCCGAG
NmeCI	GATC
NmeRI	CAGCTG
NopI	GTCGAC
NotI	GCGGCCGC
NphI	GATC
NruI	TCGCGA
NsbI	TGCGCA
NsiCI	GATATC
NsiI	ATGCAT
Nsp29132II	GGATCC
NspLKI	GGCC
NspMACI	AGATCT
NspSAIV	GGATCC
NspV	TTCGAA
NunII	GGCGCC
OkrAI	GGATCC
Pac25I	CCCGGG
PacI	TTAATTAA
Pae14kI	CCGCGG
Pae17kI	CAGCTG
Pae18kI	AGATCT
Pae2kI	AGATCT
Pae5kI	CCGCGG
PaeAI	CCGCGG
PaeBI	CCCGGG
PaeI	GCATGC
PaePI	CTGCAG
PaeQI	CCGCGG
PaeR7I	CTCGAG
PagI	TCATGA
PalAI	GGCGCGCC
PalI	GGCC
PamI	TGCGCA
PanI	CTCGAG
PauAII	TTTAAA
PauI	GCGCGC
PceI	AGGCCT
PciI	ACATGT
PciSI	GCTCTTC
PctI	GAATGC
Pde133I	GGCC
Pde137I	CCGG
PdiI	GCCGGC
PfaAII	CATATG
PfaAIII	GCATGC
Pfl21I	CTGCAG
Pfl23II	CGTACG
Pfl8I	GGATCC
PflKI	GGCC
PgaI	ATCGAT
PhaI	GCATC
PhoI	GGCC
PinAI	ACCGGT
PinBI	ATGCAT
PinBII	TCCGGA
PI-PspI	TGGCAAACAGCTATTATGGGTATTATGGGT
PI-SceI	ATCTATGTCGGGTGCGGAGAAAGAGGTAATGAAATGGCA
PlaAII	GTAC
PlaI	GGCC
PlaII	TTCGAA
Ple19I	CGATCG
PleI	GAGTC
PluTI	GGCGCC
PmaCI	CACGTG
Pme55I	AGGCCT
PmeI	GTTTAAAC
PmlI	CACGTG
PpaAI	TTCGAA
PpaAII	TCGA
PpeI	GGGCCC
PpsI	GAGTC
Ppu10I	ATGCAT
Ppu111I	GAATTC
PpuAI	CGTACG
PscI	ACATGT
PshBI	ATTAAT
PsiI	TTATAA
Psp124BI	GAGCTC
Psp1406I	AACGTT
Psp23I	CTGCAG
PspAI	CCCGGG
PspALI	CCCGGG
PspCI	CACGTG
PspFI	CCCAGC
PspLI	CGTACG
PspOMI	GGGCCC
PstI	CTGCAG
PstNHI	GCTAGC
Psu161I	CGATCG
PtaI	TCCGGA
Pun14627I	TGCGCA
Pun14627II	CAGCTG
Pvu84II	CAGCTG
PvuI	CGATCG
PvuII	CAGCTG
RalF40I	GATC
RcaI	TCATGA
RflFI	GTCGAC
RflFII	AGTACT
RgaI	GCGATCGC
RigI	GGCCGGCC
RleAI	CCCACA
RmaI	CTAG
Rme21I	ATCGAT
RsaI	GTAC
RsaNI	GTAC
RshI	CGATCG
RspLKI	GCATGC
RspLKII	GGATCC
RspXI	TCATGA
RsrI	GAATTC
Rtr63I	GTCGAC
RtrI	GTCGAC
SacI	GAGCTC
SacII	CCGCGG
SalI	GTCGAC
SalPI	CTGCAG
SapI	GCTCTTC
SarI	AGGCCT
Sau3239I	CTCGAG
Sau3AI	GATC
SauBMKI	GCCGGC
SauHPI	GCCGGC
SauLPI	GCCGGC
SauLPII	CTCGAG
SauMI	GATC
SauNI	GCCGGC
SauSI	GCCGGC
SbfI	CCTGCAGG
Sbi68I	CTCGAG
Sbo13I	TCGCGA
SbvI	GGCC
ScaI	AGTACT
SceIII	GCCGGC
SchI	GAGTC
SchZI	CCGCGG
SciI	CTCGAG
SciNI	GCGC
SdaI	CCTGCAGG
SelI	CGCG
SenPT14bI	CCGCGG
SenPT16I	CGGCCG
SepI	ATGCAT
SexBI	CCGCGG
SexCI	CCGCGG
SfaAI	GCGATCGC
SfaI	GGCC
SfaNI	GCATC
SflI	CTGCAG
SfoI	GGCGCC
Sfr274I	CTCGAG
Sfr303I	CCGCGG
SfuI	TTCGAA
SgfI	GCGATCGC
SgrBI	CCGCGG
SgrDI	CGTCGACG
SgsI	GGCGCGCC
SimI	GGGTC
SlaI	CTCGAG
Slu1777I	GCCGGC
SmaI	CCCGGG
SmiI	ATTTAAAT
SmuI	CCCGC
SnaBI	TACGTA
SnoI	GTGCAC
Sol10179I	CTCGAG
SolI	GGATCC
SpaHI	GCATGC
SpeI	ACTAGT
SphI	GCATGC
SplI	CGTACG
SpmI	ATCGAT
SpoI	TCGCGA
SpuI	CCGCGG
SrfI	GCCCGGGC
Srl32DII	GAATTC
Srl55DI	GAATTC
Srl5DI	CTGCAG
SrlI	GCCGGC
Sru30DI	AGGCCT
Sru4DI	ATTAAT
SruI	TTTAAA
SsbI	AAGCTT
Sse232I	CGCCGGCG
Sse8387I	CCTGCAGG
Sse9I	AATT
SseAI	GGCGCC
SseBI	AGGCCT
SsiAI	GATC
SsiBI	GATC
SsiI	CCGC
SsoI	GAATTC
Ssp1I	TTCGAA
Ssp27144I	ATCGAT
Ssp4800I	TGTACA
Ssp5230I	GACGTC
SspBI	TGTACA
SspCI	GCCGGC
SspD5I	GGTGA
SspD5II	ATGCAT
SspDI	GGCGCC
SspI	AATATT
SspRFI	TTCGAA
SsrI	GTTAAC
Sst12I	CTGCAG
SstI	GAGCTC
SstII	CCGCGG
SteI	AGGCCT
Sth132I	CCCG
Sth134I	CCGG
Sth368I	GATC
SthI	GGTACC
StrI	CTCGAG
StsI	GGATG
StuI	AGGCCT
SuaI	GGCC
SunI	CGTACG
SurI	GGATCC
SviI	TTCGAA
SwaI	ATTTAAAT
TaiI	ACGT
TaqI	TCGA
TaqII	GACCGACACCCA
TasI	AATT
ThaI	CGCG
TliI	CTCGAG
Tru1I	TTAA
Tru9I	TTAA
TscI	ACGT
Tsp1I	ACTGG
Tsp32I	TCGA
Tsp32II	TCGA
Tsp49I	ACGT
Tsp509I	AATT
TspDTI	ATGAA
TspEI	AATT
TspGWI	ACGGA
TspMI	CCCGGG
TthHB8I	TCGA
Uba153AI	CAGCTG
Uba4009I	GGATCC
UbaM39I	CAGCTG
UthSI	CCCGGG
Vha464I	CTTAAG
VneI	GTGCAC
VpaK32I	GCTCTTC
VspI	ATTAAT
XbaI	TCTAGA
XcaI	GTATAC
XciI	GTCGAC
XcyI	CCCGGG
XhoI	CTCGAG
XmaCI	CCCGGG
XmaI	CCCGGG
XmaIII	CGGCCG
XmaJI	CCTAGG
XorII	CGATCG
XpaI	CTCGAG
XspI	CTAG
YenI	CTGCAG
ZhoI	ATCGAT
ZraI	GACGTC
ZrmI	AGTACT
Zsp2I	ATGCAT
