Name	Recognition Site
AaaI	CGGCCG
AagI	ATCGAT
AarI	CACCTGC
AatI	AGGCCT
AatII	GACGTC
AauI	TGTACA
AbaI	TGATCA
AbeI	CCTCAGC
AbrI	CTCGAG
AccII	CGCG
AccIII	TCCGGA
Acc16I	TGCGCA
Acc36I	ACCTGC
Acc65I	GGTACC
Acc113I	AGTACT
AccBSI	CCGCTC
AccEBI	GGATCC
AceII	GCTAGC
AceIII	CAGCTC
AciI	CCGC
AclI	AACGTT
AclNI	ACTAGT
AclWI	GGATC
AcpI	TTCGAA
AcuI	CTGAAG
AcvI	CACGTG
AfaI	GTAC
Afa22MI	CGATCG
Afa16RI	CGATCG
AfeI	AGCGCT
AflII	CTTAAG
AgeI	ACCGGT
AhaIII	TTTAAA
AhaB8I	GGTACC
AhlI	ACTAGT
AhyI	CCCGGG
AitI	AGCGCT
AjoI	CTGCAG
AliI	GGATCC
AliAJI	CTGCAG
AluI	AGCT
AlwI	GGATC
Alw26I	GTCTC
Alw44I	GTGCAC
AlwXI	GCAGC
Aor13HI	TCCGGA
Aor51HI	AGCGCT
AosI	TGCGCA
ApaI	GGGCCC
ApaCI	GGATCC
ApaLI	GTGCAC
ApiI	CTGCAG
AscI	GGCGCGCC
AseI	ATTAAT
AsiI	GGATCC
AsiAI	ACCGGT
AsiSI	GCGATCGC
AsnI	ATTAAT
Asp713I	CTGCAG
Asp718I	GGTACC
AspA2I	CCTAGG
Asp10HI	TTCGAA
Asp26HI	GAATGC
Asp27HI	GAATGC
Asp35HI	GAATGC
Asp36HI	GAATGC
Asp40HI	GAATGC
Asp50HI	GAATGC
AspLEI	GCGC
AspMI	AGGCCT
AspMDI	GATC
AssI	AGTACT
AsuII	TTCGAA
AsuHPI	GGTGA
AsuNHI	GCTAGC
AviII	TGCGCA
AvrII	CCTAGG
AvrBII	CCTAGG
BalI	TGGCCA
BamHI	GGATCC
BanIII	ATCGAT
BanAI	GGCC
BauI	CACGAG
BavI	CAGCTG
BavAI	CAGCTG
BavBI	CAGCTG
BavCI	ATCGAT
BbeI	GGCGCC
Bbi24I	ACGCGT
BbrI	AAGCTT
Bbr7I	GAAGAC
BbrPI	CACGTG
BbsI	GAAGAC
BbuI	GCATGC
BbvI	GCAGC
BbvII	GAAGAC
Bbv16II	GAAGAC
BbvAII	ATCGAT
BbvAIII	TCCGGA
BbvCI	CCTCAGC
BccI	CCATC
Bce83I	CTTGAG
Bce243I	GATC
Bce751I	GGATCC
BceAI	ACGGC
BceBI	CGCG
BcefI	ACGGC
Bci29I	ATCGAT
BciBI	ATCGAT
BciVI	GTATCC
BclI	TGATCA
BcmI	ATCGAT
Bco5I	CTCTTC
Bco27I	CCGG
Bco116I	CTCTTC
BcoAI	CACGTG
BcoKI	CTCTTC
BcuI	ACTAGT
BdiI	ATCGAT
BecAII	GGCC
BepI	CGCG
BfaI	CTAG
BfiI	ACTGGG
Bfi57I	GATC
BfrI	CTTAAG
BfrBI	ATGCAT
BfuI	GTATCC
BfuAI	ACCTGC
BfuCI	GATC
BglII	AGATCT
BimI	TTCGAA
Bim19I	TTCGAA
Bim19II	GGCC
BinI	GGATC
BlfI	TCCGGA
Bli41I	ATCGAT
Bli86I	ATCGAT
Bli736I	GGTCTC
BliAI	ATCGAT
BliRI	ATCGAT
BlnI	CCTAGG
BloHII	CTGCAG
BluI	CTCGAG
Bme12I	GATC
Bme361I	GGCC
Bme585I	CCCGC
BmgBI	CACGTC
BmrI	ACTGGG
BmtI	GCTAGC
BnaI	GGATCC
BpiI	GAAGAC
BpmI	CTGGAG
BpoAI	ATTAAT
Bpu14I	TTCGAA
Bpu95I	CGCG
BpuAI	GAAGAC
BpuAmI	GAGCTC
BpuB5I	CGTACG
BpuEI	CTTGAG
BpuSI	GGGAC
BsaI	GGTCTC
Bsa29I	ATCGAT
BsaMI	GAATGC
BscI	ATCGAT
Bsc91I	GAAGAC
BscAI	GCATC
BscCI	GAATGC
BscFI	GATC
Bse1I	ACTGG
BseAI	TCCGGA
BseCI	ATCGAT
Bse3DI	GCAATG
BseGI	GGATG
BseKI	GCAGC
BseMI	GCAATG
BseMII	CTCAG
BseNI	ACTGG
BsePI	GCGCGC
BseQI	GGCC
BseRI	GAGGAG
BseXI	GCAGC
BseX3I	CGGCCG
BseYI	CCCAGC
BseZI	CTCTTC
BsgI	GTGCAG
BshI	GGCC
Bsh1236I	CGCG
BshFI	GGCC
BshTI	ACCGGT
BsiI	CACGAG
BsiCI	TTCGAA
BsiMI	TCCGGA
BsiQI	TGATCA
BsiSI	CCGG
BsiWI	CGTACG
BsiXI	ATCGAT
BslFI	GGGAC
BsmI	GAATGC
BsmAI	GTCTC
BsmBI	CGTCTC
BsmFI	GGGAC
Bso31I	GGTCTC
BsoMAI	GTCTC
Bsp13I	TCCGGA
Bsp19I	CCATGG
Bsp50I	CGCG
Bsp63I	CTGCAG
Bsp67I	GATC
Bsp68I	TCGCGA
Bsp98I	GGATCC
Bsp105I	GATC
Bsp106I	ATCGAT
Bsp119I	TTCGAA
Bsp120I	GGGCCC
Bsp123I	CGCG
Bsp143I	GATC
Bsp211I	GGCC
Bsp423I	GCAGC
Bsp1407I	TGTACA
Bsp2095I	GATC
Bsp4009I	GGATCC
BspAI	GATC
BspA2I	CCTAGG
Bsp153AI	CAGCTG
BspAAI	CTCGAG
BspAAII	TCTAGA
BspAAIII	GGATCC
BspANI	GGCC
BspBI	CTGCAG
BspBRI	GGCC
BspBS31I	GAAGAC
BspCI	CGATCG
BspCNI	CTCAG
BspDI	ATCGAT
BspEI	TCCGGA
BspFI	GATC
BspHI	TCATGA
BspIS4I	GAAGAC
BspJI	GATC
BspJII	ATCGAT
BspKI	GGCC
BspKT5I	CTGAAG
BspKT6I	GATC
BspKT8I	AAGCTT
BspLAI	GCGC
BspLAII	TTCGAA
BspLAIII	AAGCTT
BspLU11I	ACATGT
BspLU11III	GGGAC
BspMI	ACCTGC
BspMII	TCCGGA
BspM39I	CAGCTG
BspM90I	GTATAC
BspMAI	CTGCAG
BspMKI	GTCGAC
BspO4I	CAGCTG
BspOVII	ATCGAT
BspPI	GGATC
BspRI	GGCC
BspST5I	GCATC
BspTI	CTTAAG
BspT104I	TTCGAA
BspTNI	GGTCTC
BspTS514I	GAAGAC
BspXI	ATCGAT
BspXII	TGATCA
BspZEI	ATCGAT
BsrI	ACTGG
BsrBI	CCGCTC
BsrDI	GCAATG
BsrGI	TGTACA
BsrSI	ACTGG
BssHI	CTCGAG
BssHII	GCGCGC
BssIMI	GGGTC
BssNAI	GTATAC
BssSI	CACGAG
BstI	GGATCC
Bst6I	CTCTTC
Bst11I	ACTGG
Bst12I	GCAGC
Bst19I	GCATC
Bst19II	GATC
Bst28I	ATCGAT
Bst40I	CCGG
Bst71I	GCAGC
Bst98I	CTTAAG
Bst1107I	GTATAC
BstAUI	TGTACA
BstBI	TTCGAA
Bst2BI	CACGAG
BstBSI	GTATAC
BstBS32I	GAAGAC
BstBZ153I	GCGCGC
BstD102I	CCGCTC
BstENII	GATC
BstEZ359I	GTTAAC
BstFI	AAGCTT
BstF5I	GGATG
BstFNI	CGCG
BstFZ438I	CCCGC
BstGZ53I	CGTCTC
BstH9I	GGATC
BstHHI	GCGC
BstHPI	GTTAAC
BstKTI	GATC
BstMBI	GATC
Bst31NI	CCGCTC
BstNZ169I	ATCGAT
BstOZ616I	GGGAC
BstPZ418I	GGATG
BstPZ740I	CTTAAG
BstRZ246I	ATTTAAAT
BstSNI	TACGTA
BstSWI	ATTTAAAT
BstT7I	TGATCA
Bst31TI	GGATC
BstTS5I	GAAGAC
BstUI	CGCG
BstVI	CTCGAG
BstV1I	GCAGC
BstV2I	GAAGAC
BstZI	CGGCCG
BstZ17I	GTATAC
Bsu6I	CTCTTC
Bsu15I	ATCGAT
Bsu23I	TCCGGA
Bsu1532I	CGCG
BsuBI	CTGCAG
BsuFI	CCGG
BsuRI	GGCC
BsuTUI	ATCGAT
BteI	GGCC
BtgZI	GCGATG
BtkI	CGCG
BtkII	GATC
BtrI	CACGTC
BtsI	GCAGTG
BveI	ACCTGC
BvuBI	CGTACG
CacI	GATC
CauB3I	TCCGGA
CbiI	TTCGAA
CboI	CCGG
CciNI	GCGGCCGC
CcoI	GCCGGC
CcrI	CTCGAG
CcyI	GATC
CdiI	CATCG
CelI	GGATCC
CeqI	GATATC
CflI	CTGCAG
CfoI	GCGC
Cfr6I	CAGCTG
Cfr9I	CCCGGG
Cfr42I	CCGCGG
CfrA4I	CTGCAG
CfrJ4I	CCCGGG
CfuI	GATC
CfuII	CTGCAG
ChaI	GATC
ClaI	ATCGAT
CltI	GGCC
CpfI	GATC
CscI	CCGCGG
CsiAI	ACCGGT
CsiBI	GCGGCCGC
Csp6I	GTAC
Csp45I	TTCGAA
CspAI	ACCGGT
CspBI	GCGGCCGC
Csp68KII	TTCGAA
Csp68KIII	ATGCAT
Csp68KVI	CGCG
CspKVI	CGCG
CstI	CTGCAG
CstMI	AAGGAG
CviAI	GATC
CviAII	CATG
CviQI	GTAC
CviRI	TGCA
CviRII	GTAC
DmaI	CAGCTG
DpaI	AGTACT
DpnI	GATC
DpnII	GATC
DraI	TTTAAA
DsaII	GGCC
EacI	GGATC
Eae46I	CCGCGG
EaeAI	CCCGGG
EagI	CGGCCG
EagBI	CGATCG
Eam1104I	CTCTTC
EarI	CTCTTC
EciI	GGCGGA
EclI	CAGCTG
Ecl136II	GAGCTC
EclRI	CCCGGG
EclXI	CGGCCG
Ecl37kI	CTGCAG
Ecl2zI	CTGCAG
Eco31I	GGTCTC
Eco32I	GATATC
Eco47III	AGCGCT
Eco52I	CGGCCG
Eco56I	GCCGGC
Eco57I	CTGAAG
Eco72I	CACGTG
Eco78I	GGCGCC
Eco105I	TACGTA
Eco147I	AGGCCT
Eco255I	AGTACT
EcoA4I	GGTCTC
EcoICRI	GAGCTC
EcoO44I	GGTCTC
EcoRI	GAATTC
EcoRV	GATATC
EcoT22I	ATGCAT
EcoVIII	AAGCTT
Eco29kI	CCGCGG
Eco53kI	GAGCTC
EgeI	GGCGCC
EheI	GGCGCC
ErhB9I	CGATCG
EsaBC3I	TCGA
EsaBC4I	GGCC
Esp3I	CGTCTC
Esp4I	CTTAAG
FalII	CGCG
FaqI	GGGAC
FatI	CATG
FauI	CCCGC
FauBII	CGCG
FauNDI	CATATG
FbaI	TGATCA
FdiII	TGCGCA
FgoI	CTAG
FnuCI	GATC
FnuDI	GGCC
FnuDII	CGCG
FnuDIII	GCGC
FnuEI	GATC
FokI	GGATG
FseI	GGCCGGCC
FspI	TGCGCA
FspII	TTCGAA
FspBI	CTAG
FunI	AGCGCT
FunII	GAATTC
GalI	CCGCGG
GceI	CCGCGG
GceGLI	CCGCGG
GdiI	AGGCCT
GstI	GGATCC
GsuI	CTGGAG
HacI	GATC
HaeIII	GGCC
HalI	GAATTC
HalII	CTGCAG
HapII	CCGG
HgaI	GACGC
HgiCIII	GTCGAC
HgiDII	GTCGAC
HhaI	GCGC
Hin1II	CATG
Hin2I	CCGG
Hin6I	GCGC
HinP1I	GCGC
HindIII	AAGCTT
HjaI	GATATC
HpaI	GTTAAC
HpaII	CCGG
HphI	GGTGA
HpyAV	CCTTC
HpyBI	GTAC
HpyCI	GATATC
HpyC1I	CCATC
HpyCH4I	CATG
HpyCH4IV	ACGT
HpyCH4V	TGCA
HpyF44III	TGCA
HsoI	GCGC
Hsp92II	CATG
HspAI	GCGC
HsuI	AAGCTT
KasI	GGCGCC
KpnI	GGTACC
Kpn2I	TCCGGA
Kpn378I	CCGCGG
Kpn49kI	GAATTC
KspI	CCGCGG
Ksp22I	TGATCA
Ksp632I	CTCTTC
KspAI	GTTAAC
Kzo9I	GATC
LcaI	ATCGAT
LlaAI	GATC
LlaCI	AAGCTT
LlaG2I	GCTAGC
LplI	ATCGAT
LspI	TTCGAA
LweI	GCATC
MaeI	CTAG
MaeII	ACGT
MaeK81I	CGTACG
MavI	CTCGAG
MbiI	CCGCTC
MboI	GATC
MboII	GAAGA
MchI	GGCGCC
MchAI	GCGGCCGC
MchAII	GGCC
MfeI	CAATTG
MfoAI	GGCC
MgoI	GATC
MhaAI	CTGCAG
MkrAI	GATC
MlaI	TTCGAA
MlaAI	CTCGAG
MlsI	TGGCCA
MltI	AGCT
MluI	ACGCGT
Mlu23I	GGATCC
Mlu31I	TGGCCA
MluB2I	TCGCGA
MluNI	TGGCCA
MlyI	GAGTC
Mly113I	GGCGCC
MnlI	CCTC
MnoI	CCGG
Mph1103I	ATGCAT
MroI	TCCGGA
MroNI	GCCGGC
MscI	TGGCCA
MseI	TTAA
MspI	CCGG
Msp20I	TGGCCA
MspCI	CTTAAG
MspSWI	ATTTAAAT
MssI	GTTTAAAC
MstI	TGCGCA
MthZI	CTAG
MunI	CAATTG
Mva1269I	GAATGC
MvnI	CGCG
MvrI	CGATCG
MxaI	GAGCTC
NaeI	GCCGGC
NarI	GGCGCC
NblI	CGATCG
NcoI	CCATGG
NcrI	AGATCT
NcuI	GAAGA
NdaI	GGCGCC
NdeI	CATATG
NdeII	GATC
NgoAIII	CCGCGG
NgoAIV	GCCGGC
NgoMIV	GCCGGC
NgoPII	GGCC
NgoPIII	CCGCGG
NheI	GCTAGC
NlaII	GATC
NlaIII	CATG
NmeCI	GATC
NmeRI	CAGCTG
NopI	GTCGAC
NotI	GCGGCCGC
NphI	GATC
NruI	TCGCGA
NsbI	TGCGCA
NsiI	ATGCAT
NsiCI	GATATC
NspV	TTCGAA
Nsp29132II	GGATCC
NspLKI	GGCC
NspMACI	AGATCT
NspSAIV	GGATCC
NunII	GGCGCC
OkrAI	GGATCC
PacI	TTAATTAA
Pac25I	CCCGGG
PaeI	GCATGC
PaeAI	CCGCGG
PaeBI	CCCGGG
PaePI	CTGCAG
PaeQI	CCGCGG
PaeR7I	CTCGAG
Pae2kI	AGATCT
Pae5kI	CCGCGG
Pae14kI	CCGCGG
Pae17kI	CAGCTG
Pae18kI	AGATCT
PagI	TCATGA
PalI	GGCC
PamI	TGCGCA
PanI	CTCGAG
PauI	GCGCGC
PauAII	TTTAAA
PceI	AGGCCT
PciI	ACATGT
PctI	GAATGC
Pde133I	GGCC
Pde137I	CCGG
PdiI	GCCGGC
PfaAII	CATATG
PfaAIII	GCATGC
Pfl8I	GGATCC
Pfl21I	CTGCAG
Pfl23II	CGTACG
PflKI	GGCC
PgaI	ATCGAT
PhaI	GCATC
PhoI	GGCC
PinAI	ACCGGT
PinBI	ATGCAT
PinBII	TCCGGA
PlaI	GGCC
PlaII	TTCGAA
PlaAII	GTAC
PleI	GAGTC
Ple19I	CGATCG
PmaCI	CACGTG
PmeI	GTTTAAAC
Pme55I	AGGCCT
PmlI	CACGTG
PpaAI	TTCGAA
PpaAII	TCGA
PpeI	GGGCCC
PpsI	GAGTC
Ppu10I	ATGCAT
Ppu111I	GAATTC
PpuAI	CGTACG
PshBI	ATTAAT
PsiI	TTATAA
Psp23I	CTGCAG
Psp1406I	AACGTT
PspAI	CCCGGG
PspALI	CCCGGG
Psp124BI	GAGCTC
PspCI	CACGTG
PspLI	CGTACG
PspOMI	GGGCCC
PstI	CTGCAG
PstNHI	GCTAGC
Psu161I	CGATCG
PtaI	TCCGGA
Pun14627I	TGCGCA
Pun14627II	CAGCTG
PvuI	CGATCG
PvuII	CAGCTG
Pvu84II	CAGCTG
RalF40I	GATC
RcaI	TCATGA
RflFI	GTCGAC
RflFII	AGTACT
RleAI	CCCACA
RmaI	CTAG
Rme21I	ATCGAT
RsaI	GTAC
RshI	CGATCG
RspLKI	GCATGC
RspLKII	GGATCC
RspXI	TCATGA
RsrI	GAATTC
RtrI	GTCGAC
Rtr63I	GTCGAC
SacI	GAGCTC
SacII	CCGCGG
SalI	GTCGAC
SalPI	CTGCAG
SapI	GCTCTTC
SarI	AGGCCT
Sau3239I	CTCGAG
Sau3AI	GATC
SauBMKI	GCCGGC
SauHPI	GCCGGC
SauLPI	GCCGGC
SauLPII	CTCGAG
SauMI	GATC
SauNI	GCCGGC
SauSI	GCCGGC
SbfI	CCTGCAGG
Sbi68I	CTCGAG
Sbo13I	TCGCGA
SbvI	GGCC
ScaI	AGTACT
SceIII	GCCGGC
SchI	GAGTC
SchZI	CCGCGG
SciI	CTCGAG
SciNI	GCGC
SdaI	CCTGCAGG
SelI	CGCG
SenPT16I	CGGCCG
SenPT14bI	CCGCGG
SepI	ATGCAT
SexBI	CCGCGG
SexCI	CCGCGG
SfaI	GGCC
SfaNI	GCATC
SflI	CTGCAG
SfoI	GGCGCC
Sfr274I	CTCGAG
Sfr303I	CCGCGG
SfuI	TTCGAA
SgfI	GCGATCGC
SgrBI	CCGCGG
SimI	GGGTC
SlaI	CTCGAG
Slu1777I	GCCGGC
SmaI	CCCGGG
SmiI	ATTTAAAT
SmuI	CCCGC
SnaBI	TACGTA
SnoI	GTGCAC
SolI	GGATCC
Sol10179I	CTCGAG
SpaHI	GCATGC
SpeI	ACTAGT
SphI	GCATGC
SplI	CGTACG
SpmI	ATCGAT
SpoI	TCGCGA
SpuI	CCGCGG
SrfI	GCCCGGGC
SrlI	GCCGGC
Srl5DI	CTGCAG
Srl32DII	GAATTC
Srl55DI	GAATTC
SruI	TTTAAA
Sru4DI	ATTAAT
Sru30DI	AGGCCT
SsbI	AAGCTT
Sse9I	AATT
Sse232I	CGCCGGCG
Sse8387I	CCTGCAGG
SseAI	GGCGCC
SseBI	AGGCCT
SsiI	CCGC
SsiAI	GATC
SsiBI	GATC
SsoI	GAATTC
SspI	AATATT
Ssp1I	TTCGAA
Ssp4800I	TGTACA
Ssp5230I	GACGTC
Ssp27144I	ATCGAT
SspBI	TGTACA
SspCI	GCCGGC
SspD5I	GGTGA
SspD5II	ATGCAT
SspRFI	TTCGAA
SsrI	GTTAAC
SstI	GAGCTC
SstII	CCGCGG
Sst12I	CTGCAG
SteI	AGGCCT
SthI	GGTACC
Sth132I	CCCG
Sth134I	CCGG
Sth368I	GATC
StrI	CTCGAG
StsI	GGATG
StuI	AGGCCT
SuaI	GGCC
SunI	CGTACG
SurI	GGATCC
SviI	TTCGAA
SwaI	ATTTAAAT
TaiI	ACGT
TaqI	TCGA
TaqII	GACCGACACCCA
TasI	AATT
ThaI	CGCG
TliI	CTCGAG
Tru1I	TTAA
Tru9I	TTAA
TscI	ACGT
Tsp1I	ACTGG
Tsp32I	TCGA
Tsp32II	TCGA
Tsp49I	ACGT
Tsp509I	AATT
TspDTI	ATGAA
TspEI	AATT
TspGWI	ACGGA
TthHB8I	TCGA
Uba4009I	GGATCC
Uba153AI	CAGCTG
UbaM39I	CAGCTG
UthSI	CCCGGG
Vha464I	CTTAAG
VneI	GTGCAC
VpaK32I	GCTCTTC
VspI	ATTAAT
XbaI	TCTAGA
XcaI	GTATAC
XciI	GTCGAC
XcyI	CCCGGG
XhoI	CTCGAG
XmaI	CCCGGG
XmaIII	CGGCCG
XmaCI	CCCGGG
XmaJI	CCTAGG
XorII	CGATCG
XpaI	CTCGAG
XspI	CTAG
YenI	CTGCAG
ZhoI	ATCGAT
ZraI	GACGTC
ZrmI	AGTACT
Zsp2I	ATGCAT
I-CeuI	TAACTATAACGGTCCTAAGGTAGCGA
PI-SceI	ATCTATGTCGGGTGCGGAGAAAGAGGTAATGAAATGGCA
AanI	TTATAA
AbsI	CCTCGAGG
AjiI	CACGTC
AluBI	AGCT
AsiGI	ACCGGT
BcoDI	GTCTC
BmcAI	AGTACT
BpvUI	CGATCG
BshVI	ATCGAT
BsnI	GGCC
BspACI	CCGC
BspFNI	CGCG
BspOI	GCTAGC 
BssMI	GATC
BstAFI	CTTAAG
BtsIMutI	CAGTG
BtuMI	tcgcga
CciI	tcatga
CseI	gacgc
DinI	GGCGCC
EcoP15I	CAGCAG
FaeI	CATG
GlaI	GCGC
GsaI	CCCAGC
I-PpoI	TAACTATGACTCTCTTAAGGTAGCCAAAT
I-SceI	TAGGGATAACAGGGTAAT
MalI	GATC
MauBI	CGCGCGCG
MluCI	AATT
MreI	CGCCGGCG
NmeAIII	GCCGAG
PalAI	GGCGCGCC
PciSI	GCTCTTC
PI-PspI	TGGCAAACAGCTATTATGGGTATTATGGGT
PluTI	GGCGCC
PscI	ACATGT
PspFI	CCCAGC
RgaI	GCGATCGC
RigI	GGCCGGCC
RsaNI	GTAC
SfaAI	GCGATCGC
SgrDI	CGTCGACG
SgsI	GGCGCGCC
SspDI	GGCGCC
TspMI	CCCGGG

